111111111111111111111111111111111111111111111
10000000001C100000000000100010000000000000001
10000000001010000000000010P010000000000000001
100000000000000000000000111110000000000000001
1000E0000000000000000000000000000000000000001
111111111111111111111111111111111111111111111
