111111111111111111111111111111111111111111111
10000000001C100000000000100010000000000000001
100000000010100000000000100010000000000000001
100000000010100000000000110110000P00000000001
1000000000000000000EC000000000000000000000001
111111111111111111111111111111111111111111111
