11111111111111111111011111111
10000000001C10000000000000001
1000000000101000000000000P001
10000000000000000000000000001
1000E000000000000000000000001
11111111111111111111111111111
