111111111111111111111111111111111111111111111
10000000001C100000000000100010000000000000001
10000000001000000000000010P010000000000000001
100000000000E00000000000110110000000000000001
100000000000000000C00000000000000000000000001
111111111111111111111111111111111111111111111
